################################
#S#      #               #     #
# # ## #    ###########  # ### #
#      # #  #    #    #  #   # #
##########  # ####### #  # # # #
#        #  # #     # #  # # # #
# ######    # # # # # #  # # # #
#        #  # # # # # # ###### #
##########  #   # #   #        #
#        #  ##### ############ #
#        #      # #   #      # #
#  #  #  ###### # # ##### #### #
#  #  #         # #     #      #
#  #  #  ## ##### ##### ###### #
####  ####  #   # #   # # # #  #
#        ## # ### ### #        #
# #    # #  # #     # ##### ####
# #    # ## # #     #     # ## #
# #    # #  # #  #  # # # # ## #                                          
# ##  ##### #         # # # #  #
#  #  #     ##### ##### ### # ##
## #### #####   #   #       #  #
#     #     # # ### #       #  #
##### ##### # #  X# #########  #
#   # #   # # ### #            #
### # # # # # #   #            #
#   # # ##### # # # ##  #####  #
# ### #     # #   # #       # ##
#     # ##### # # # #       #  #
# ##### #   ###   # ####### ## #
#         #     # #    #     # #
################################