#####################################################################################################
#S              # #   #       #   #     #             #       # #   # # # #     #   # # # #       # #
# # ######### # # # ### # ####### ##### # ##### ### # # ### ### ### # # # ### ##### # # # # ### ### #
# # # #     # #     #   #   # # # #   #   # # # # # #   # # #             #   #     #   #   #   #   #
### # ### ##### ### # ##### # # # ### ##### # # # ####### # ##### ### # ### ### # ##### # ### # ### #
#   #           # #   #   # #         #     #   #         # #     # # # #       #           # # #   #
### ####### # # # ### # # ####### ##### ##### # # ### ############# # ##### # # # # # ##### ### ### #
#     # #   # #   #     #   #       # #       #   # # # # # #   #   # # # # # # # # #   # # #   #   #
### ### # # ############### # # ##### ####### ### # # # # # # # ### # # # # # ####### ### # ##### ###
#   # #   # #     # # # #     # #     # #   # # # #       #   # # #         # #   #       #       # #
# # # ####### ### # # # ### ####### # # ### ### # ### ##### ##### ##### ####### # ### # ##### ### # #
# # # #     # #   #                 # #   #   #   #   # #   #     #     # #     # # # #     # #   # #
### # # ### ##### ### ### ### # ####### ### ### ####### ### # ##### # ### ##### ### ### ########### #
#   # # #     #   # #   #   # #           #   # # # # # #     #     # #     #             # #       #
# # # ### # ### ### # ### ####### ######### ### # # # # # ##### # ##### # ##### ########### ### # # #
# #   #   # # #         # #         # #     #       #           # #   # #     #     #   #   #   # # #
##### # ##### ### # # # # ### ### ### # ######### ######### ### ### ### ### ### ### # ### ### ### # #
#       # #       # # # # #   # #   # #     #       #   # # #             # #   # #       #   #   # #
### ##### ######### ######### # # ### # # ### ##### ### # ##### # ############# # # # # ##### # # ###
#               #     #     # # #       #   # #       #   # #   #   # # #   #   # # # #     # # # # #
# ########### # # ####### ##### ####### ### # ########### # # ### # # # ### ### # # ### ##### ##### #
#       #     # # # #   #                 #       #     #   # # # #   #   # # #   #   #         #   #
####### # ### ### # # # # ##### ### # # # # ####### ### # ### # ####### ### # # ########### # ##### #
#       # #   #   #   #     # # #   # # # # #   #     #         #   #     #         #     # #   # # #
# # ########### ##### ####### # ##### # ####### ### ### ### ### # ####### ##### ##### # ### ##### # #
# #   # #     # #         #       # # # #   # #     #   # # # # #   #         # #   # #   #   # # # #
####### ### ####### # ### ##### ### # ### # # ##### # # # ### ### ##### # ####### ### ##### ### # # #
# #     #   # #   # # #       #   #   #   #   #     # #               # #       #   # #         #   #
# # ##### ### # ####### ####### ##### ### ### ### # ### # ##### ### ### ##### # # ### ##### ##### # #
#         # #               # # # #       #   #   # #   #     #   # #   #     # #     #     # # # # #
# ### # # # ####### ##### # # # # # ### ### ######### # ### ##### ### # ### ##### ##### ### # # # ###
#   # # #               # # # # #   #     #   #       #   #   # # #   #   # # # #     # #       #   #
# ##### ### # # ### ######### ### ##### ### ### # ##### # ##### # # ### ##### # # ##### # # ### # ###
# #   #   # # #   #   #   #   #   # # #   #   # # #   # #       # # #     #   # #   # # # #   # #   #
# ### # ### ### ##### ### # ### # # # ############# ##### ####### # # ### ### # ### # # # ######### #
# #   # # #   #     #   #   # # # # # #         # # #     #     # # # # # # #           #   # # # # #
# ### ### # ### ####### # # # # ### # # ### # ### # ### # # # ### ### # ### ### # ##### ##### # # # #
# # #     # #       #   # #   #       #   # #   #     # #   # #         # #   # # #       #     # # #
### ### # # ####### ######### ### ### ### # # ### # ### # ##### ####### # # ##### # ### ### ##### # #
#     # #       # #       # #     # # # # # #     #   # #   # # # #     #       # # # #   #         #
### ####### # ### ### # # # # # ### # # ##### ### ### ##### # ### ######### ### # # # ##### # ##### #
#     #     # #       # # # # #     #     # # #   #   #         #   #     # #   # # #   # # # #     #
# ### # ### ####### ####### ### # # ### # # # ### # ######### ##### # # ##### # ##### ### ##### ### #
# #     # # # #     #       #   # #   # # # #   # #       # #         #   #   #   #         #   # # #
##### ### ### ####### ### ##### ### ####### # ####### ##### # ### # # ### # # ##### # ### ####### # #
#         #       #   #       # #   #       # #   #     #   # #   # # #     #     # # #   # # #     #
# ############### # # ##### ##### ### ### ### ### # # ### ### ### ### # # ### ### # ##### # # # ### #
#       # #   #     # #   #   #     #   #     #     #   #       #   # # # #   #     #         # #   #
### # # # ### # # ### ### # # # ### # # ### # # # ##### # ##### ##### ####### ### # ### ### ####### #
#   # #   #   # #   # # #   # # # # # #   # # # # # # # #   #     #   #   # #   # # #     # # # #   #
# # ### ##### ### ##### ##### ### # ##### # ### ### # ##### # ##### ### ### # ############# # # ### #
# #   # #   #           #   # # # # #   # # #     # #       # #   # # #             #           # # #
# ####### ### ##### ####### # # # # # ### ### # ### ### ### ### # ### ### ##### # ####### ### # # # #
#   #   #   #     #       #   #   #     # # # # #       # # #   #   # #   # # # #   #   # #   # #   #
####### # ### ### ### # ### ##### # # ##### # # ### ### # ### ### ### # # # # ##### # ######### ### #
#   #   # #   #   #   #   #   #   # # #   #   # # # #   # # # #   #     # #     # # #   #   # # #   #
### ### # # ### # ########### ### # # # ### # ### # ##### # # # # ####### ### # # # ### ### # # # ###
# #     #   #   #       #   #       # #     # # #     #     # # #   #     #   # #   #   #       # # #
# # # # ######### ### # ### ### ### # # # ### # # ### # ####### ### # ##### ####### # # ######### # #
#   # #     # # # # # #   #       # #   #   #     # #   # #       #     #   # # # #   #     #       #
######### # # # # # ####### # ### ### ### # # ### # ##### ### # ####### # ### # # ##### # ### ### # #
#   # # # # #       #     # # #     # #   # # #   #   # #     # #     #             # # #     #   # #
# # # # ### ####### ##### ##### ####### # ##### ### ### ### # # # ### ######### ##### ### ### #######
# #                 #     #         #   #     #   #     #   # #     # #     #   # # #     #         #
####### # ##### ##### ####### # ##### ####### # ### ##### ### ### ##### # # # # # # ### ##### ##### #
#       #   # # # # #     # # # # # # #       # # #     # #   # #     # # #   # #   #       # #     #
####### # # # # # # # ### # ##### # # ######### # ##### ### ### ######### ##### # ####### # # # ### #
#   # # # # #           # #     #     #             #     # #       #   #   #   #         # # # #   #
# # # # # ########### ##### ####### ####### ####### # ##### ### # ### ### ##### ##### # ########### #
# #     #       #       #     #       #   #     #       #   # # # #           #   #   #   #     # # #
# ######### ### # # ### ### ##### ####### # ##### # # ### ### # # # # # # # # # ##### # ##### # # # #
# #       # # # # # #   #       # # # #     #   # # #   #       # # # # # # # # #   # #       #   # #
### ####### # # ### ####### # ##### # # ####### ### ##### ##### # # ### ######### ### ### ####### ###
#   # # #   # # # # #       #   #   #         #     #   # # #   # #   # # #     #       #     #   # #
# ### # ##### ### ######### ### # ### ### ### ### # # ##### # ##### ##### # # ####### # ##### ### # #
#             # # #       # #       # #   #   # # # # #     # #       #     # #     # # #       #   #
### ### ### # # # ### ### ### # ####### ####### # ### # ### # # # ######### ##### # # ### ##### ### #
# # #   #   #   #     #     # #       # #             #   # # # # #   #     # #   #   # # # #   # # #
# ####### ### ##### # ####### ############# ##### ######### ####### # ### # # ### ### # ### ### # # #
# # # # # #   # #   # #     #               #             #   #     # # # #     # #     #     # #   #
# # # # ### ### ### ### ### ### ####### ############### ### ##### # # # ####### # # # ### ####### ###
#             #   #     #     #   #           # #     #   #   #   # # # #     #   # # #     # #     #
# # ### ##### # # # ### ##### # ##### # # ### # # # ####### ##### # # # ### ### ####### # ### # ### #
# # # # #     # #   #   # # # #   #   # # #     # # # #     # # # # #     #           # #     #   # #
# # # # # ##### ##### ### # ####### ##### ##### ### # # # # # # ### ### ### # # ####### ######### # #
# # # # # #         # #   #     # # # # # # #           # #     #   # #     # # # # #   # # # # # # #
# ### ### # # ### ##### ### ### # ### # ### # # ##### # # ##### ##### # # ### # # # ### # # # # ### #
#   #       # # #     #     # # #   #         # #   # # # #     #   #   #   # # #     # # #     #   #
# ####### ### # ### ######### # # ### # ########### ####### # ##### ### ######### # ### # ### # ### #
#   # # # #     #       #         #   #     #   # # # # # # # # #         # #   # # #   #     # #   #
### # # # ####### ##### # ### ######### ### ### # # # # # ##### # # ####### ### # ### # ### #########
#   #     #     # # #   # # #   #       # # #     #   #     #   # # #   #   # #   # # # #   #   #   #
# ####### ### # # # ####### # ### ### ### # # # # # ####### # ### ### # # ### # ### ### # # # ### ###
# #     #   # #   # # #   #         # #   # # # # # #       #         #     #         #   #   #     #
####### # ##### # # # ### # ##### ##### # # # ### # ##### ##### ############# ##### # ##### # # ### #
#     #     #   # #         #   # #     # #     # #               # #         #   # # #     #     # #
##### # ##### # ######### # # ### ####### # ######### ######### ### ####### ### # # # ####### ### ###
#         #   #     #     #   #     #   #   #   #     #   #     #   # #   #   # # # #   #   # #     #
# ### ### # # ### # # ##### # ####### # # # ### ### ##### # # ### ### ### ####### # ### ### ##### ###
#   # #   # # #   #     #   # #       #   # #       #       #                         #            X#
#####################################################################################################